NO      ./files/textures/wall.xpm
C      200,200,200

WE      ./files/textures/wall.xpm

F     200,200,200


SO    ./files/textures/wall.xpm



EA     ./files/textures/wall.xpm

111111   1111         111111
110W01   100111111111      1
110001   1001111111   111111
11001111110011111   111
110000000000    11  111
11111111111111111  111
1111              1111
111111111111111111111
