NO ./files/textures/wall.xpm
SO ./files/textures/wall.xpm
WE ./files/textures/wall.xpm
EA ./files/textures/wall.xpm

F 255,255,255
C 255,255,255

        11111111111
    1111111111111111111
  110011        11110001
 10001              11001
 1001       111111    1001
 1001     11011   1    101
 101      101     1    101
 101      101   11    1001
 101      1001      11001
 1001      1111111111111
 1001        11111
  1001
   10W11
    11111 
       111111
          1111111
              1111