NO  ./files/textures/wall.xpm
F	0,100,0
SO ./files/textures/wall.xpm


EA ./files/textures/white_square.xpm
C 100,100,255
WE ./files/textures/white_square.xpm

111111111111111
100100000001001
100100100100011
100000100111111
1000N0000000001
100010000000001
100111000101111
100010000100001
100000000100001
111111111111111
