NO ./files/textures/stark.xpm
SO ./files/textures/martell.xpm
WE ./files/textures/lannister.xpm
EA ./files/textures/targaryen.xpm

F 46,219,111
C 42,189,219

111111   111111
1001011111001011
100100100100011
10000010011111111111111111111
1000000N000000000000000000001
10001000000000111111111111111
100111000101111
100010000100001
100000000100001
111111111111111
