NO      ./files/textures/wall.xpm
C      200,200,200

WE      ./files/textures/wall.xpm

F     200,200,200


SO    ./files/textures/wall.xpm



EA     ./files/textures/wall.xpm

111111
110W01
110001
110011
110D01
111111
