NO  ./files/textures/wall.xpm
F	0,100,0
SO ./files/textures/wall.xpm


EA ./files/textures/white_square.xpm
C 100,100,255
WE ./files/textures/white_square.xpm

111111111111
100000000001
10000S000001
100000000001
111111111111

111111111111
100000000001
100000000001
100000000001
111111111111