NO  ./files/textures/wall.xpm
F	255,255,0
SO ./files/textures/wall.xpm


EA ./files/textures/white_square.xpm
C 42,9,219
WE ./files/textures/white_square.xpm

1111111
1001001
1000101
1N00011
1111111