NO  ./files/textures/wall.xpm
F	255,255,0
SO ./files/textures/wall.xpm


EA ./files/textures/white_square.xpm
C 42,9,219
WE ./files/textures/white_square.xpm

111111111
100000001
100010001
100101001
100010101
1N0101001
111111111