WE ./files/textures/wall.xpm
NO ./files/textures/wall.xpm
EA ./files/textures/wall.xpm
SO ./files/textures/wall.xpm

C 125,10,30
F 120,100,40

             11111111111
           11111111111111111
          1100000000011111111
         11100011111111111111
        1110001111000000000111
   111111000111110000000000111
 11111111000111111000000001111
 1110011100001111111111111111
 1110011100000111111111111111
 11100111000000000000000000111
 11000111000000000000000000111
 11000111000000000N00000000111
 11100111000000000000000000111
 1110011100000000000000000111
   111111100000001111111000111
         11000000111 111000111
         11000000111 111001111
         1111111111   11111111
          11111111