NO      ./files/textures/north.txt
C      200,200,200

WE      ./files/textures/west.txt

F     200,200,200


SO    ./files/textures/south.txt



EA     ./files/textures/east.txt

111111   1111
110W01   1001
110001   1001
1100111111001111
110000000000    1
1111111111111111
