NO ./files/textures/wall.xpm
SO ./files/textures/wall.xpm
WE ./files/textures/wall.xpm
EA ./files/textures/wall.xpm

C 42,9,219
F 46,219,0


         111111111111
         100000000001
         100000000001
         100001000001
         100011100001
         100001000001
         100000000001
         100000000001
         100000000001
         100000000001 
111111111100000000001111111111
100000000000000000000000000001
100000000000001000000000000001
100000100000011100000010000001
100001110000111110000111000001
100000100000011100000010000001
100000000000001000000000000001
100000000000000000000000000001
10000000000000N000000000000001
111111111100000000001111111111
         100000000001
         100000000001
         100000000001
         100000000001
         100001000001
         100011100001
         100001000001
         100000000001
         100000000001
         111111111111